0	1	2	3	4	5	-1	9	10	11	12	-1	
1	2	-1	4	5	6	7	8	9	10	11	-1	
2	3	-1	5	6	7	-1	9	10	11	12	-1	
3	4	5	6	7	8	9	10	11	12	13	-1	
-1	5	6	7	-1	9	10	-1	-1	13	14	-1	
7	6	7	8	9	10	11	-1	-1	14	-1	-1	
8	7	8	9	10	11	12	13	14	15	16	-1	
-1	8	9	10	11	12	13	14	15	16	17	18	
10	9	-1	-1	-1	-1	-1	-1	-1	-1	-1	19	
